R 450 450
NO ./textures/bluestone.xpm
SO ./textures/greystone.xpm
WE ./textures/redbrick.xpm
EA ./textures/wood.xpm
S ./textures/barrel.xpm
F 177,36,36
C 0,0,0

11111111111111111
1E000000000000001
10000000000000001
10000022200000001
10000000000000001
11111111111111111