R 1100 1100

NO ./textures/eagle.xpm
SO ./textures/eagle.xpm
WE ./textures/eagle.xpm
EA ./textures/eagle.xpm
S ./textures/barrel.xpm

F 255,36,36
C 0,0,0

11111111111111111
10000000000000001
10000000000000001
10000022200000001
1000000000000S001
11111111111111111